1111111111131111111011111112023113024111111121111111311111111111
111111111140011111102211111102011131111011131111000031110001001110001111111111111
1111111111111111111111000001111121110001104020020110331020111133100011111111111111111111111111111111
1111111111001111142011111120111111020111132001111332311111111111
1111111111401111110200111110101113101001132001011300020111111111
1111111111111111111111111111110000011111000311101111101010000111110102021301111010020010111103120201011111000010101111101113000041110000011000111111111111111111111111111
1111111111111111111111110010411110001001111202020111102110011110101011133333001111111111111111111111
1111111111111111111111110000111130211011133202004113302020111111110011111111111111111111111111111111
1111111111111111111111110011000111100020001111201110211110133310111101333101110200200201100000104011111111111111111111111
1111111111100001111222011402330110233311111100111111111111111111
111111111111111111111111111111111111111111111111110011110001102011112001100233330201110000104011111111111111111111111111111111111111
111111111111111111100411100230111003230111102201111000111111111111111111
1111111111133111111031111100231111020011100122011004000111111111
1111111111111111100100011023320114232011102332011001000111111111
1111111111111111110000111020220113333331102202011110411111111111
1111111111111111111111100001111110200001111020110113330200011333212011111101020111110040011111111111
1111111111111111111000011111022211111001331111100332011104000001111111111111111111
11111111111111111111111000130111100233311100201231110112101110002002011000100001111111140111111111111111111111
1111111111111111111111333301111113332111100212020110220012011000010001111104011111111111111111111111
1111111111332331113313311102220111002001110222011100140111111111
